238 238 238 238 238 238 239 238 239 238 239 238 239 238 239 238 239 238 239 238 239 238 239 238 239 238 239 238 239 238 
238 238 238 239 238 215 216 216 217 216 217 216 217 216 217 216 217 216 217 216 217 216 217 216 217 216 217 216 217 216 
239 238 215 216 216 195 195 194 195 194 195 194 195 194 195 194 195 194 195 194 195 194 195 194 195 194 195 194 195 194 
215 216 195 195 194 195 194 195 195 194 195 194 195 194 195 195 195 195 195 195 195 195 194 194 195 92 47 47 47 47 
195 194 195 195 194 194 194 194 217 216 217 216 217 216 217 217 217 217 217 217 217 217 217 217 217 46 298 273 273 273 
195 194 194 194 194 194 194 215 197 197 197 197 197 197 197 197 197 197 197 197 197 197 197 197 197 46 1 135 135 134 
194 194 194 194 194 194 215 197 197 197 197 197 197 197 197 197 197 197 197 197 197 197 92 47 47 4 44 268 223 223 
195 194 194 194 194 215 197 197 197 197 197 197 197 197 92 47 47 47 47 47 47 47 4 137 0 0 44 222 177 178 
194 194 194 216 215 197 238 238 197 197 197 197 197 197 46 0 0 0 0 0 0 0 137 0 0 0 44 222 199 200 
194 194 215 238 197 238 238 238 197 197 197 197 197 197 91 45 45 2 0 0 0 0 0 0 0 0 44 222 181 182 
194 215 197 197 238 238 238 238 197 197 197 197 197 197 196 194 194 46 0 0 137 0 0 0 0 0 44 222 203 204 
215 197 238 238 238 197 197 92 47 47 47 47 47 47 47 47 47 4 0 0 0 0 0 0 0 0 44 222 176 176 
197 197 197 197 197 197 197 46 0 0 0 0 0 0 0 0 0 0 0 0 0 0 0 0 0 137 44 222 176 176 
197 197 197 197 197 197 197 46 0 0 0 0 0 0 0 0 0 0 276 231 231 231 231 231 231 231 277 222 176 176 
197 197 197 197 197 197 197 46 0 0 137 0 0 0 276 231 231 231 184 184 184 185 229 229 229 229 274 222 181 182 
197 197 197 197 92 47 47 4 0 0 0 0 0 276 188 184 184 184 184 184 184 228 0 0 0 0 44 222 203 204 
197 197 197 92 4 0 0 0 0 0 0 276 231 188 185 229 229 229 186 184 184 228 0 0 137 0 44 222 176 176 
197 197 92 0 0 0 0 0 137 0 0 230 184 184 228 0 0 0 230 184 184 228 0 0 0 0 44 222 176 176 
197 197 46 0 0 0 0 0 0 0 0 230 184 184 228 0 0 0 230 184 184 228 0 0 0 0 44 222 176 176 
197 197 46 0 0 0 0 0 0 0 0 230 184 184 228 0 0 0 230 184 184 228 0 0 0 0 44 222 181 182 
197 197 46 0 0 0 0 0 0 0 0 230 184 184 187 231 231 231 188 184 184 228 0 0 0 137 44 222 203 204 
197 197 46 0 0 0 0 0 0 0 0 275 186 184 184 184 184 184 184 184 184 228 0 0 0 0 44 222 176 176 
197 197 46 0 0 0 0 0 0 0 0 0 275 229 229 229 229 229 229 229 229 274 0 0 0 0 44 222 176 176 
197 197 46 0 0 0 0 0 0 0 0 0 0 0 0 0 0 0 0 0 0 0 0 0 1 45 90 269 247 247 
197 197 46 0 0 0 0 0 0 137 0 0 0 0 0 0 0 137 0 0 0 0 137 0 44 194 196 216 216 216 
197 197 91 45 45 2 0 0 0 0 137 0 0 0 0 0 0 0 0 137 0 0 0 0 44 216 218 238 238 238 
238 238 193 194 195 91 136 136 136 136 136 136 136 136 136 136 136 136 136 136 136 136 136 136 90 238 240 197 197 197 
238 238 215 216 217 193 194 195 195 194 194 195 194 194 195 194 194 195 194 194 195 194 194 195 196 197 197 197 197 197 
238 197 237 238 239 215 216 217 217 216 216 217 216 216 217 216 216 217 216 216 217 216 216 217 218 197 197 197 197 197 
238 238 238 238 238 237 238 239 239 238 238 239 238 238 239 238 238 239 238 238 239 238 238 239 240 197 197 197 197 197
